202
0 11 0 96 64 160 0 0 0 0
1 11 0 352 448 32 0 0 0 0
2 11 64 736 960 32 0 0 0 0
3 11 256 704 64 32 0 0 0 0
4 11 386 640 64 32 0 0 0 0
5 21 318 704 64 64 0 0 0 0
6 22 698 690 64 36 0 0 0 0
7 22 830 690 64 36 0 0 0 0
8 22 958 690 64 36 0 0 0 0
9 11 450 608 64 32 0 0 0 0
10 11 450 320 960 32 0 0 0 0
11 11 514 546 960 32 0 0 0 0
12 11 1026 800 320 32 0 0 0 0
13 11 1442 352 32 32 0 0 0 0
14 11 1474 98 32 352 0 0 0 0
15 21 1342 446 96 96 0 0 0 0
16 21 1310 544 64 64 0 0 0 0
17 11 1474 408 32 96 0 0 0 0
18 11 1346 706 64 128 0 0 0 0
19 11 1474 480 128 96 0 0 0 0
20 11 1440 674 224 32 0 0 0 0
21 11 1570 866 32 352 0 0 0 0
22 11 1600 928 64 32 0 0 0 0
23 21 1632 926 64 64 0 0 0 0
24 21 1663 833 64 64 0 0 0 0
25 11 1600 994 512 32 0 0 0 0
26 11 1666 610 384 32 0 0 0 0
27 11 2240 608 64 32 0 0 0 0
28 11 1730 768 64 32 0 0 0 0
29 11 1858 768 64 32 0 0 0 0
30 11 1986 736 128 32 0 0 0 0
31 11 2174 736 128 32 0 0 0 0
32 11 2108 928 64 32 0 0 0 0
33 11 2498 608 192 32 0 0 0 0
34 11 2754 544 32 32 0 0 0 0
35 11 2818 608 192 32 0 0 0 0
36 11 2690 674 64 32 0 0 0 0
37 11 2368 738 640 32 0 0 0 0
38 11 3074 684 32 32 0 0 0 0
39 19 3086 892 44 96 0 0 0 0
40 11 3200 1058 64 32 0 0 0 0
41 11 3266 994 128 32 0 0 0 0
42 11 3458 992 192 32 0 0 0 0
43 11 3648 1058 64 32 0 0 0 0
44 11 3714 1122 64 32 0 0 0 0
45 11 3810 994 160 32 0 0 0 0
46 11 3778 1026 32 128 0 0 0 0
47 11 4002 1058 32 32 0 0 0 0
48 11 4034 866 32 352 0 0 0 0
49 21 3840 1216 160 160 0 0 0 0
50 11 4034 1250 32 128 0 0 0 0
51 11 3938 1440 128 32 0 0 0 0
52 11 3586 1568 480 32 0 0 0 0
53 21 3806 1568 128 128 0 0 0 0
54 21 3742 1374 128 128 0 0 0 0
55 11 3618 1346 32 128 0 0 0 0
56 11 3650 1376 256 32 0 0 0 0
57 12 3990 1450 16 32 0 0 0 0
58 30 3990 1450 32 16 3990 1450 4022 1570
59 12 3738 1436 16 32 0 0 0 0
60 30 3738 1436 16 16 3738 1436 3788 1570
61 12 3860 1268 16 32 0 0 0 0
62 30 3860 1268 16 16 3860 1268 3888 1374
63 9 3650 1314 44 64 3650 1314 3809 1380
64 3 3666 1268 32 32 3666 1268 3898 1380
65 15 434 1376 16 32 0 0 0 0
66 12 3990 886 16 32 0 0 0 0
67 30 3990 886 16 16 3990 886 4028 1114
68 12 3872 886 16 32 0 0 0 0
69 30 3872 886 16 16 3872 886 4028 1114
70 12 3738 886 16 32 0 0 0 0
71 30 3738 886 16 16 3738 886 3774 1122
72 12 3610 886 16 32 0 0 0 0
73 30 3610 886 16 16 3610 886 3642 992
74 9 3712 1056 44 64 3712 1056 3774 1120
75 3 3666 890 32 32 3666 890 3966 992
76 15 3776 994 64 64 0 0 0 0
77 29 3778 994 28 28 3666 890 3966 992
78 12 3480 888 16 32 0 0 0 0
79 30 3480 888 16 16 3480 888 3516 992
78 12 3480 888 16 32 0 0 0 0
81 32 3898 880 30 30 3898 880 3356 992
82 12 3224 876 16 32 0 0 0 0
83 30 3224 876 16 16 3224 876 3264 1056
84 9 3326 928 44 64 3326 928 3390 992
85 17 3132 992 3266 992 0 0 0 0
86 12 2966 876 16 32 0 0 0 0
87 30 2966 876 16 16 2966 876 3008 992
88 12 2844 876 16 32 0 0 0 0
89 30 2844 876 16 16 2844 876 2880 992
90 12 2718 876 16 32 0 0 0 0
91 30 2718 876 16 16 2718 876 2750 992
92 12 2590 876 16 32 0 0 0 0
93 30 2590 876 16 16 2590 876 2622 992
94 12 2460 876 16 32 0 0 0 0
95 25 2460 876 16 16 2460 876 2490 992
96 12 2334 876 16 32 0 0 0 0
97 30 2334 876 16 16 2334 876 2366 992
98 12 2212 876 16 32 0 0 0 0
99 30 2212 876 16 16 2212 876 2270 992
100 12 2082 930 16 32 0 0 0 0
101 30 2082 930 16 16 2082 930 2110 992
102 12 1948 896 16 32 0 0 0 0
103 30 1948 896 16 16 1948 896 1986 992
102 12 1948 896 16 32 0 0 0 0
105 30 1824 958 16 16 1824 958 1844 992
106 12 1688 880 16 32 0 0 0 0
107 30 1688 880 16 16 1688 880 1726 994
108 6 2282 880 720 112 2282 880 3002 992
109 6 2452 880 720 112 2452 880 3002 992
110 6 2602 880 720 112 2602 880 3002 992
111 6 2752 880 720 112 2752 880 3002 992
112 12 1690 692 16 32 0 0 0 0
113 30 1690 692 16 16 1690 692 1706 784
114 12 1940 674 16 32 0 0 0 0
113 30 1690 692 16 16 1690 692 1706 784
116 6 1725 670 577 118 2302 778 1725 670
117 6 1725 670 577 118 1982 778 1725 670
118 6 1725 670 577 118 2180 778 1725 670
119 6 1725 670 577 118 2096 778 1725 670
120 17 2044 608 2240 608 0 0 0 0
121 17 2300 608 2498 608 0 0 0 0
122 12 2254 682 16 32 0 0 0 0
123 30 2254 682 16 16 2254 682 2492 738
124 9 2273 929 44 64 2273 929 2369 993
125 12 2290 676 16 32 0 0 0 0
126 30 2290 676 16 16 2290 676 2876 738
127 9 2499 672 44 64 2499 672 2656 608
128 12 2710 518 16 32 0 0 0 0
129 30 2710 518 16 16 2710 518 2748 672
130 12 2584 508 16 32 0 0 0 0
131 27 2584 508 32 32 2584 508 2622 608
132 12 2328 534 16 32 0 0 0 0
133 30 2328 534 16 16 2328 534 2364 994
134 12 2072 534 16 32 0 0 0 0
135 30 2072 534 16 16 2072 534 2108 738
136 6 1660 502 386 106 1660 502 2046 608
137 6 1730 502 577 118 1730 502 2046 608
138 6 1862 502 577 118 1862 502 2046 608
139 6 1986 502 577 118 1986 502 2046 608
140 12 1820 524 16 32 0 0 0 0
141 30 1820 524 16 16 1820 524 1854 608
142 15 1408 672 16 16 0 0 0 0
143 12 1300 688 16 32 0 0 0 0
141 30 1820 524 16 16 1820 524 1854 608
145 12 1172 688 16 32 0 0 0 0
146 30 1172 688 16 16 1172 688 1214 798
147 12 1040 688 16 32 0 0 0 0
148 30 1040 688 16 16 1040 688 1086 798
149 12 918 688 16 32 0 0 0 0
150 30 918 688 16 16 918 688 960 738
151 12 786 688 16 32 0 0 0 0
152 30 786 688 16 16 786 688 830 738
153 12 658 688 16 32 0 0 0 0
154 30 658 688 16 16 658 688 702 738
155 12 542 648 16 32 0 0 0 0
156 30 542 648 16 16 542 648 574 738
157 12 542 648 16 16 0 0 0 0
158 30 274 580 16 16 274 580 316 708
159 5 741 516 467 28 741 516 1200 547
160 4 610 481 32 64 610 481 610 481
161 4 482 546 32 64 482 546 482 546
162 5 382 701 415 28 798 738 382 701
163 12 1438 228 16 32 0 0 0 0
164 30 1438 228 16 16 1438 228 1468 350
165 12 1304 228 16 32 0 0 0 0
166 30 1304 228 16 16 1304 228 1342 324
167 12 1174 228 16 32 0 0 0 0
168 30 1174 228 16 16 1174 228 1342 324
169 12 1044 228 16 32 0 0 0 0
170 30 1044 228 16 16 1044 228 1088 324
171 12 912 228 16 32 0 0 0 0
172 34 912 228 16 16 912 228 958 324
173 12 660 228 16 32 0 0 0 0
174 30 660 228 16 16 660 228 702 324
175 6 574 174 828 150 574 174 1402 324
176 6 729 174 828 150 729 174 1402 324
177 6 853 174 828 150 853 174 1402 324
178 6 1061 174 828 150 1061 174 1402 324
179 12 508 228 16 32 0 0 0 0
180 30 508 228 16 16 508 228 542 324
181 12 406 228 16 32 0 0 0 0
182 30 406 228 16 16 406 228 444 356
183 11 3010 480 32 352 0 0 0 0
184 11 2176 994 960 32 0 0 0 0
185 11 3586 1250 32 96 0 0 0 0
186 15 1408 674 32 32 0 0 0 0
187 15 2786 544 32 32 0 0 0 0
188 15 3778 994 32 32 0 0 0 0
189 15 4034 1378 32 32 0 0 0 0
190 15 4034 1410 32 32 0 0 0 0
191 11 4066 1378 32 64 0 0 0 0
192 11 4066 1282 32 64 0 0 0 0
193 11 4034 1476 32 96 0 0 0 0
194 1 199 260 65 64 199 260 199 260
195 33 2786 544 32 32 0 0 0 0
196 33 1408 674 32 32 0 0 0 0
197 39 1780 810 659 20 1780 810 2439 830
198 39 3112 1152 396 30 3112 1152 3508 1180
199 19 1546 575 44 96 0 0 0 0
200 9 2880 546 44 64 2880 546 3004 610
201 9 2530 546 44 64 2530 546 2655 610
